****#***#***#**#****
****#***#***#**#****
****#***#***#**#****
****#***#***#**#****
##*##***##*##**##*##
********************
*********###********
#####**#*******#####
****#**#****#**#****
*******#****#*******
****#*******#**#****
#####***###****#####
********************
********************
********************
##*##***##*##**##*##
****#***#***#**#****
****#***#***#**#****
****#***#***#**#****
****#***#***#**#****