*******
*####**
*#####*
*#####*
*##****
*#####*
*#####*
*#####*
*###***
*******