******
**###*
*#**#*
***#**
****#*
*#**#*
**#*#*
******